       1111111111111111111111111
       1000000000110000000000001
       1011000001110000001000001
1111111110010000000000001 100000111111111
111110101011000001110000010000001
111111110011000001110111111111111
    1110111111011100000010001
    111111111101110101001000111111111
1111000011010101110000001000110000011
100000000000010011000000100011111111
10000000000011101101010010001
11000001110101011111011110N01    
11110111 1110101 101111010001
11111111 1111111 111111111111  
11111111 1111111 111111111111
