1111111 000
100001N1
1000001
1E0001
111111
