11111111
10000101
100N0011
100001 1
10000011
10000001
11000001
1 100001
11111111
