111111111111111
100000000000001
1001100W0000001
100100000000001
100111110000001
100001010100001
100000000000001
100000000000001
100000000000001
100000000000001
111111111111111
