111111
1E000111
100001
100001
111111
