11111111
10000101
100N0011
10000111
11111111
