111111111111111111
100001000000000001
100000100000000001
100001 10000000001
100000100000000001
100000000000000001
110000000000000001
1 1000000000000E01
111111100000000001
       10000000001
       10000000001
       10000000001
       10000000001
       10000000001
       11111111111
