11111111111111111111111111111111111111111111111111111111
           110000000000000010000000000000000000000000001
           100000000000000000000000000001111111111111111
11111111111100000000000000000000000000001
10000000000000000000000000000000000000001
11000000000000010000000000000000000000001
111111111111001100N0000000000000000000001
           100100000000000000000000000001
           100111110000000000000000000001
           100001010100000000000111111111
111111111111111111000000000000011
100000000000001111111111111111111
100000000000001
100000000000001
111111111111111
