111111
10000111
100001
10N001
111111
