111111111
101000101
1010N0101
110000011
111111111
