111111111
101000101
1010N0D01
110000111
111111111
