111111111
101000D011111
1010N000000001
1100001111111
111111111
