111111111
101000D01
1010N0D01
110000111
111111111
