111111111
100000001
1000N0001
110000011
111111111
