11111111
10000001
1001D1001
10000001
1001N101
10000101
10000001
10000001
11111111
