11111111
10000001
1001D101
10000001
100DN001
10000101
10000001
10000001
11111111
