NO ./textures/TECH_3B.xpm
SO ./textures/TECH_3F.xpm
WE ./textures/TECH_3I.xpm
EA ./textures/TECH_4F.xpm
DO ./textures/DOOR_1E.xpm

F      28      ,       28  ,    27           
C  2,75,110 


           111111111111111111111111111111111111111111111
           11000000000000001N000000000000000000000000001
           100000000000000000000000000001111111111111111
11111111111100000000000000000000000000001
10000000000000000000000000000000000000001
11000000000000010001000000000000000000001
11111111111100110000100000000000000000001
           100100000000000000000000000001
           100111110000000000000000000001
           100001010100000000000111111111
111111111111111111000000000000011
100000000000001111111111111111111
100000000000001
100000000000001
111111111111111
