NO ./textures/Labwall_North.xpm
SO ./textures/SUPPORT_5B.xpm
WE ./textures/Labwall_West.xpm
EA ./textures/Labwall_East.xpm

F   255,   255    ,    255,
C  255,        255          ,255

11111111
10000001
1001D101
10000001
100DD001
10011001
1000D001
1001N101
10000101
10000001
10000001
11111111
